G110KF0100  
D111000E00  
I001D111000C
D1E001100F02
80H0HK108   
111EFF01I   
1110F00080  