11FB011
100FF01
10F0F01
1F0F001
10F2F01