110B011
100FF01
10F0F01
100F001
10F2F01