111190060
111111100
BD0000102
110000100
110000E00