20011000 
0FNFN0N1
0N0111F01
 011800F0
100110100
0F001E000
0FF01011N
0F001C1G0