G111001000  
D11100E000  
0001D110000C
D1E001100002
80D0D0100900
111EFF10000 
1110F001000 