100011G01
1D10C1001
100111DE1
11E180FF1
80FK111E1
100F00001
1I1020011
15810FE81