000001000000
000001000000
111101000000
000000000000
000000200000
000000000000