20011000
0FN0N000
0N010000
 011000 
00010000
0F010000
00001B  