1C10I01111
1N181F11G1
00100011I1
0I0H0010N0
1110001000
1LE00F0021
1110000011