 1D0C1G81
 1I1110F1
 10181101
11E1300I1
80FK111D1
100F0F000
1I102F0F0
158101111